NO 546
SO r53467
WE ghjk
EA yuedsj
F fwevdsj


11111
11111