F 2,2,2
C 3,2,2

NO nort_path
SO south_path
EA east_path
WE west_path

11111
1S101111111
10000000001
10111111111
111
