  WE                            textures/test2/west.png
NO      textures/test2/north.png
SO textures/test2/south.png
F      139, 69, 19
EA textures/test2/east.png
C 108, 187, 255

1111111
1W00001
1111111
