F 2, 2, 3
C 3, 2, 2

NO nort_path
SO south_path
EA east_path
WE west_path

     1111111111
1111111111
1111111111
