F 2, 2, 2
C 3, 2, 2

NO nort_path
SO south_path
EA east_path
WE west_path

11111
10101
10201
101W1
11111
