   WE                            texs/hugui.png
NO      texs/marti.png



SO texs/toti.png

F      21, 14, 157

EA texs/geri.png



C 67, 190, 191

111111111111111111111111
100000000000000000000001
100000000000000000000001
100000000000000000000001
100000111110000121210001
100000100010000200020001
100000100010000100010001
100000100010000200020001
100000112110000121210001
100000000000000000000001
100000000000000000000001
100000000000000000000001
100000000000000000100001
100000000000000000010001
100000000000000000000001
100000000000000000000001
111111111000000000000001
110100001000000000000001
110200001000000000000001
110100001000000000000001
110111111000000000000001
110000000000000E00000001
111111111000000000000001
111111111111111111111111
