   WE                            texs/west.png
NO      texs/north.png



SO texs/south.png

F   69, 222, 199

EA texs/east.png



C 235, 198, 52

111111111
100000001
100000001
1N0000001
111111111
