   WE                            texs/west.png
NO      texs/north.png



SO texs/south.png

F   139,    90,     43

EA texs/east.png




C 102,163,255

11111111111
10000000001
10121012101
10202020201
10121010101
10000000001
10000012101
10000020201
10000012101
1E000000001
11111111111

