   WE                            texs/west.png
NO      texs/north.png



SO texs/south.png

F      17,    38,     64

EA texs/east.png



C 218, 234, 235

1111111111111111111111111
10S0110000100000000000001
1000110000200000111111001
1000110000100000110001001
1000000000100000000001001
1111111111111111111111111
